111111111111
100000000001
10P000000001
111111111101
100000C00101
100000000101
100000000101
100000000101
100000000101
101111111101
100000000G01
111111111111